ID,Name,Quantity,Cost,Sale,Total Cost,Total Sale,Profit
1,Sushi,3,10,100,30,300,270
2,Gyuudon,5,2,100,10,500,490
3,Yakiniku,12,10,100,120,1200,1080
4,Soba,2,3,100,6,200,194
5,Ramen,3,90,100,270,300,30
6,Sashimi,5,12,100,60,500,440
7,Curry Rice,8,3,100,24,800,776
8,Udon,10,12,100,120,1000,880
9,Unadon,21,10,100,210,2100,1890
10,Takoyaki,1,5,100,5,100,95
11,Sukiyaki,2,30,100,60,200,140
12,Shabu,9,120,100,1080,900,-180